111111111111111111111111111111
100000000000001000000000000001
100111111111101000000000100001
100000000010001111110111111101
100011111110000000000000000001
100000100010000000000000000001
100111100011111111000000000001
100000000010000000000000000001
100001001111011111111110000001
100001001000000100000000100001
100001000001000100000000100001
100001001001000111111000100001
100001001001000000000000111001
100001001000000100000111100001
100001011111000111111100000001
100000000100010001000100011001
100000000100010101000111110001
101111100100010101000000000001
100000000000000100000100000001
111111111111111111111111111111